
WE      ./Textures/wall3.xpm
SO      ./Textures/wall2.xpm
NO      ./Textures/wall1.xpm
EA      ./Textures/wall4.xpm

C       10,10,50
F       105,105,105

11111111111111111111111111111111
10000000000000000000000000000011
100000000000000000000000000000R1
10000000000000000000000000000011
100000000000000000000000000000R1
10000000000000000000000000000011
11DD111111111111111111111111111111111
1000000000000000000000000000000000001
1000000000000000000000000000000000001
1S00000000000000000000000000000000001
1000000000000000000000000000000000001
1011100000000000011111000000000000001
1111111111111111111111111111111111111