
WE      ./resources/wall1.xpm
SO      ./resources/wall2.xpm
NO      ./resources/wall3.xpm
EA      ./resources/wall4.xpm

C       15,15,75
F       105,105,105

111111111111111111111111111111111111111111
100000000000000000000000000000000000000001
100000000000000000000000000000000000000001
100000000000000000000000000000000000000001
100000000000000000000000000000000000000001
100000000000000000000000000000000000000001
100000000000000000000000000000000000000001
100000000001111111100000000000000000000001
100000000000N00001000000000000000000000001
100000000000000001000000000000000000000001
111111111111111111000000000000000000000001
100000000000000000000000000000000000000001
100000000000000000000000000000000000000001
100000000000000000000000000000000000000001
111111111111111111111111111111111111111111