
NO      ./resources/wall3.xpm
WE      ./resources/wall1.xpm

SO      ./resources/wall2.xpm
EA      ./resources/wall4.xpm
C       15,0,5
F       15,15,15



1111
1N001
1111
1001
 11
1