
NO      ./resources/wall3.xpm
WE      ./resources/wall1.xpm

SO      ./resources/wall2.xpm
EA      ./resources/wall4.xpm
C       15,15,75
F       105,105,105

111111111111111111111111111111
111111111100000000000000000000000000011
10000000000000000000000000000000000001
111111100000000000000000000000000000011
10S00000000000000000000000000000000011
11111110000000001111111110000000000011
10000000000000001000000001000000000001
100000000000000010000000010000000000011
11111000000000000100000000100000000001
    10000000000010000000010000000000011
    11011111111111111111111111111111111
     101                         
     101
    10001
    10001
   1000001
  100000001
1111110111111
1000000000001
1000000000001
100000000001
1000000000001
1000000000001
1111111111111