
NO      ./resources/wall3.xpm
WE      ./resources/wall1.xpm
SO      ./resources/wall2.xpm

EA      ./resources/wall4.xpm

C       20,20,20
F       105,105,105

111111111111
100000000001
100000000001
100000000001
100001000001
100000100001
100000000001
1N0000000001
100000000001
111111111111