
WE      ./resources/wall1.xpm
SO      ./resources/wall2.xpm
NO      ./resources/wall3.xpm
EA      ./resources/wall4.xpm

C       10,10,50
F       105,105,105

111111111111111111111111111111
10000100000000000000000000000011111111
10N00100000000000000000000000000000011
11011100000000000000000000000000000001
11000000000000000000000000000000000011
11000000000000001101100000000000000001
11000000000000001000100000000000000011
11000000000000001000111101000000000001
11000000000000001000000001000000000011
11111111111111111111111111111111111111