
WE      ./textures/wall1.xpm
SO      ./textures/wall2.xpm
NO      ./textures/wall3.xpm
EA      ./textures/wall4.xpm

C       10,10,50
F       105,105,105

1111111111111111111
10000000000000000001111
100111100011100000000011111111111111111
1000001000001000000000000000000000000011
1E000010000010000000000000111111111111
10011110000000000000000011
100000000000000000000001
10001000100000000000001
1111111111111111111111