
WE      ./textures/wall1.xpm
SO      ./textures/wall2.xpm
NO      ./textures/wall3.xpm
EA      ./textures/wall4.xpm

C       10,10,50
F       105,105,105

111111111111111111111111111111
10000100000000000000001R1001R11111111111111111111111111111111   
10N0010000000000000000000000000000000000000000000000000000011
11D11100000000000000000000000000000000000000000000000000000R1
1100000000000000000000000000000000000000000000000000000000011
110000000000000011D1100000000000000000000000000000000000000R1
1100000000000000100010000000000000000000000000000000000000011
11000000000000001000111101000000000000000000000000000000000R1
1100000000000000100000000100000000000000000000000000000000011
1111111111111111111111111111111111111111111111111111111111111