
WE      ./textures/WE.xpm
SO      ./textures/SO.xpm
NO      ./textures/NO.xpm
EA      ./textures/EA.xpm

C       224,30,9
F       220,100,8

        11111111111111111111111
        1000000000110000000000001
        1011000001110000000000001
        1001000000000000000000001
111111111011000001110000000000001
100000000011000001110111110111111
11110111111111011100000010001
11110111111111011101010010001
11000000110101011100000010N01
10000000000000001100000010001
10000000000000001101010010001
1100000111010101111101111000111
1111111 11111 11111111