
WE      ./textures/WE.xpm
SO      ./textures/SO.xpm
NO      ./textures/NO.xpm
EA      ./textures/EA.xpm

C       224,30,9
F       220,100,8

        1111111111111111111111111
        1000000000110000000000001
        1011000001110000000000001
        1001000000000000000000001
111111111011000001110000000000001
100000000011000001110111111111111
11110111111111011100000010001
11110111111111011101010010001
11000000110101011100000010001
100000000000000011000000100011
10000000000000001101010010001
11000001110101011111011100S01
11110111 1110101 101111010001
11111111 1111111 111111111111
