
WE      ./textures/WE.xpm
SO      ./textures/SO.xpm
NO      ./textures/NO.xpm
EA      ./textures/EA.xpm

C       224,30,9
F       220,100,8

111111111111111
    11011S111111111
    11110111111
111111111111111