
WE      ./textures/WE.xpm
SO      ./textures/SO.xpm
NO      ./textures/NO.xpm
EA      ./textures/EA.xpm

C       224,30,9

F       220,100,8

11111111111111111111111111111
10000000000000001101010010001
11000001110101011111011100E01
11110111 1110101 101111010001
11111111 1111111 111111111111
