
WE      ./textures/wall1.xpm
SO      ./textures/wall2.xpm
NO      ./textures/wall3.xpm
EA      ./textures/wall4.xpm

C       10,10,50
F       105,105,105

11111111111111111111
10000000000000000001
1001111000111000000111
10000010000010000001
1E000010000010000001
10011110000000000011
10000000000000000001
10001000100000000001
11111111111111111111