
WE      ./textures/WE.xpm
SO      ./textures/SO.xpm
NO      ./textures/NO.xpm
EA      ./textures/EA.xpm

C       224,30,9

F       220,100,8



111111111111111111111111111111111
100000000011000000000000000000001
111100000111000000000000000000001
100100000000000000000000000000001
111111111011000001110000000000001
100000000011000001110111110111111
111101111111110111000000100000001
111101111111110111000000100000001
111101111111110111000000100000001
111101111111110111000000100000001
111101111111110111000000100000001
1111011111111101110000001000000N1
111111111111111111111111111111111
