
WE      ./textures/WE.xpm
SO      ./textures/SO.xpm
NO      ./textures/NO.xpm
EA      ./textures/EA.xpm

C       224,30,9
F       220,100,8

111111111111111111111111111111111
100000000011000000000000000000001
111100000111000000000000000000001
100100000000000000000000000000001
111111111011000001110000000000001
100000000011000001110111110111111
11110111111111011100000010001
11110111111111011101010010001
11000000110101011100000010N01
10000000000000001100000010001
10000000000000001101010010001
11000001110101011111011111111
1000000000000000000001
1111111111111111111111