
WE resources/wall1.xpm
SO resources/wall2.xpm
NO resources/wall3.xpm
EA resources/wall4.xpm







C       20,20,20
F       105,105,105


         111111111111111111111111111111
111111111100000000000000000000000000011
1000000000000000000000000000000000000R1
111111100000000000000000000000000000011
10W000D000000000000000000000000000000R1
11111110000000001D111111110000000000011
1000000000000000100000000100000000000R1
100000000000000010000000010000000000011
1111100000000000010000000010000000000R1
    10000000000010000000010000000000011
    11D11111111111111111111111111111111
     101                         
     101
    10001
    10001
   1000001
  100000001
111111D111111
1000000000001
1000000000001
100000000001
1000000000001
1000000000001
1111111111111