
  WE resources/wall1.xpm
SO resources/wall2.xpm
NO resources/wall3.xpm
EA resources/wall4.xpm

C       20,20,20
F       105,105,105

  11111111111111111111111111111111111111
111111111100000000000000000000000000011
1000000000000000000000000000000000000R1
111111100000000000000000000000000000011
10W000D000000000000000000000000000000R1
11111110000000001D111111110000000000011
1000000000000000100000000100000000000R1
100000000000000010000000010000000000011
1111100000000000010000000010000000000R1
  1R000000000011111111R100000000000111
111111111111111111111111111111111111