
WE resources/wall1.xpm
SO resources/wall2.xpm
NO resources/wall3.xpm
EA resources/wall4.xpm

C       10,10,10
F       105,105,105

 1111    111111111111111111111111111111111
100001111000000000001R11111R0000000011111
100000000000000000000000000000000000111
1111111000000000000000010000000000000R1
10W000D00000000000000000100000000000011
11111110000000001D111000000000000000011
110000000000000010001111110000000000011
1100000000000000100000000100000000000R1
110000000000000010000000010000000000011
111110011111111111111111111111111111111
    1001
    1D11
    1001
     1001
      1001
       1001
111111111D1111
10000000000001
10000000000001
10000000000001
10000000000001
10000000000001
11111111111111