
WE      ./resources/wall1.xpm
SO      ./resources/wall2.xpm
NO      ./resources/wall3.xpm
EA      ./resources/wall4.xpm

C       10,10,50
F       105,105,105


                        11111111111111
                        10000000000001
                        10000000000001
                        10000000000001 
                        11111111101111
                                101
111111111111111111111111111111111D1111
10000100000000000000001R1001R100000011
10N00100000000000000000000000000000011
11D111000000000000000000000000000000R1
11000000000000000000000000000000000011
110000000000000011D11000000000000000R1
11000000000000001000100000000000000011
110000000000000010001111010000000000R1
11000000000000001000000001000000000011
11111001111111111111111111111111111111
    10001
    11D11
11111000111111
10000000000001
10000000000001
11111111111111